8 10
15
##########
## + #*#+#
#*O+ OO###
#++*#O+# #
#*+#+O +O#
#*#   *#*#
##.O+#*O*#
##########