8 10
11
##########
## + #*O #
#*O+ OO  #
#++*#O+# #
#*+#+O +O#
#*#   *#*#
##.O+#*O*#
##########