7 7
10
#######
#++.###
#OO #*#
#***O+#
##O ++#
#O # *#
#######

